################
####         P #
#     ##       #
#     #        #
#     #        #
#     #        #
# G            #
################
